NO ./assets/missing.png
WE ./assets/missing.png
SO ./assets/missing.png
EA ./assets/missing.png

F 0,32,0
C 120,0,16

 1111111       11111111111
110000011     1100000000011
100000001    110000000000011
110000011    1000000000000011
 1110111     10000000000000011
   101       110000001000000011
   101        11000011100000001
   1011111111111000001000000011
   100000000000000000000000011
   10111111111110000000000011
   101        11000000000011
   101       11000000000011
 1110111     1000000000011
110000011    1000000N0001
100000001    110000000001
110000011     11000000001
 1111111       1111111111
