NO ./assets/missing.png
SO ./assets/missing.png
WE ./assets/missing.png
EA ./assets/missing.png

F 220,100,0
C 225,30,0

111111111111111111111111111111
101000000000000000000000000001
101000000000000000000000000001
101000000011111000000001100001
100000010000000000000001100001
10N001000000000011111000000001
100000000000000000000000000001
111111111111111111111111111111
