NO ./assets/missing.png
SO ./assets/missing.png
WE ./assets/missing.png
EA ./assets/missing.png

F 220,100,0
C 225,30,0

111111111111111111111111111111
101000000000000000000000000001
101000000000000000000000000001
101000000011111000000001100001
100000010000000000000001100001
100001000000000011111000000001
100000S00000000000000000000001
100000011111111111111111111111
10000001
10000001
10000001
10100001
10100001
10100001
10000001
10000001
10000001
10000001
10000001
10000011
10000011
10000111
10000111
10000001
10000001
10000001
10000001
10000001
10000001
10000001
10000001
10000001
10000001
10000001
10000001
10000001
10000001
10000001
10000001
10000001
10000001
10000001
10000001
10000001
10000001
10000001
10000001
11111111
