NO ./assets/missing.png
SO ./assets/missing.png
WE ./assets/missing.png
EA ./assets/missing.png

F 220,100,0
C 225,30,0

11111111
10000001
10000001
10000001
1000N001
10000001
10000001
10000001
10000001
10000001
10000001
10100001
10100001
10100001
10000001
10000001
10000001
10000001
10000001
10000011
10000011
10000111
10000111
10000001
10000001
10000001
10000001
10000001
10000001
10000001
10000001
10000001
10000001
10000001
10000001
10000001
10000001
10000001
10000001
10000001
10000001
10000001
10000001
10000001
10000001
10000001
10000001
11111111
