NO ./assets/missing.png
SO ./assets/missing.png
WE ./assets/missing.png
EA ./assets/missing.png

F 220,100,0
C 225,30,0

111111111111111
100100000000001
100100000000001
11D010000000001
100001000000001
10000D000000001
100001000000001
100001000000001
100001000000001
10000011101D111
100000000100001
100000000100001
100000000100001
1000000001000W1
111111111111111
