NO ./assets/missing.png
SO ./assets/missing.png
WE ./assets/missing.png
EA ./assets/missing.png

F 220,100,0
C 225,30,0

1111111111111
1010000010001
1010111111101
1000000010001
1110101111101
1000100010001
1011101110101
1000100000101
1111101010111
1000001010001
101011111E111
1010100000001
1111111111111
