NO ./assets/missing.png
SO ./assets/missing.png
WE ./assets/missing.png
EA ./assets/missing.png

F 220,100,0
C 225,30,0

1 1 1 1 1111111111111111111111111
 1 1 1 11000000000110000000000001
1 1 1 1 1011000001110000000111101
 1 1 1 110010000000000000001  101
1111111110110000011100000001  101
100000000011000001110111111111101
111101111111110111000000100000001
111101111111110111010100100011111
11000000110101011100000000001
10000000000000001100000010001
10010000000000001101010010001
10111101110101011111011110N0111
111  111 1110101 101111010001
1      1 1111111 111111111111
1
11111111111111111111111111111111
101                            1
11111111111111111111111111111111
